==========================================================================
|  s++++++++++++++++++++++++++++++|                                      |
|                                +|                                      |
|====================            +|                                      |
|                                ++++++++++++++++++++++++++++++          |
|                                                             *          |
|                  ===================                                   |
|                                                                        |
|                                                                        |
|                                                                        |
|                *                    ==========================         |
|                                                                        |
|                                                                        |
|                                               |                        |
|================================               |                        |
|                                               |                        |
|                     *                         |                        |
|                                               |                        |
|                                               |                        |
|                                               |                       *|
==========================================================================
==========================================================================
|  s++++++++++++++++++++++++++++++|                                      |
|                                +|                                      |
|====================            +|                                      |
|                                ++++++++++++++++++++++++++++++++++++++++|
|                                                             *         +|
|                  ===================                                  +|
|                                                                       +|
|                                                                       +|
|                                                                       +|
|                *                    ==========================        +|
|+++++++++++++++++              ++++++++++++++  +++++++++++++++++++++++ +|
|+                             ++            + ++                     + +|
|+++++++++++++++++++++++++++++++ +++++++++++++ +|++++++++++++++++++++++ +|
|================================+             +|+                      +|
|                                +++++++++++++ +|++++++++++++++++++++++ +|
|                     *                      + +|                     + +|
|+++++++++++++++++++++++++++++++++++++++++++++ +|++++++++++++++++++++++ +|
|+                                             +|+                      +|
|+++++++++++++++++++++++++++++++++++++++++++++++|++++++++++++++++++++++++|
==========================================================================
==========================================================================
|  s++++++++++++++++++++++++++++++|                                      |
|                                +|                                      |
|====================            +|                                      |
|                                ++++++++++++++++++++++++++++++++++++++++|
|                                                             *         +|
|                  ===================                                  +|
|                                                                       +|
|                                                                       +|
|                                                                       +|
|                *                    ==========================        +|
|                                               +++++++++++++++++++++++ +|
|                                              ++                     + +|
|                                              +|++++++++++++++++++++++ +|
|================================              +|+                      +|
|                                              +|++++++++++++++++++++++ +|
|                     *                        +|                     + +|
|++++++++++++++++++++++                        +|++++++++++++++++++++++ +|
|+                                             +|+                      +|
|+++++++++++++++++++++++++++++++++++++++++++++++|++++++++++++++++++++++++|
==========================================================================
==========================================================================
|  s++++++++++++++++++++++++++++++|                                      |
|                                +|                                      |
|====================            +|                                      |
|                                ++++++++++++++++++++++++++++++++++++++++|
|                                                             *         +|
|                  ===================                                  +|
|                                                                       +|
|                                                                       +|
|                                                                       +|
|                *                    ==========================        +|
|                                                                       +|
|                                                                       +|
|                                               |                       +|
|================================               |                       +|
|                                               |                       +|
|                     *                         |                       +|
|                                               |                       +|
|                                               |                       +|
|                                               |                       *|
==========================================================================
